[
    """
+-+-+-+-+o+-+-+-+-+-+
|   |             | |
+ + + +-+-+-+ +-+ + +
| | |   |   | | |   |
+ +-+-+ +-+ + + + +-+
| |   |   | |   |   |
+ + + + + + + +-+ +-+
|   |   |   | |     |
+-+-+-+-+-+-+-+ +-+ +
|             |   | |
+ +-+-+-+-+ + +-+-+ +
|   |       |       |
+ + + +-+ +-+ +-+-+-+
| | |   |     |     |
+ +-+-+ + +-+ + +-+ +
| |     | | | |   | |
+-+ +-+ + + + +-+ + +
|   |   |   |   | | |
+ +-+ +-+-+-+-+ + + +
|   |       |     | |
+-+-+-+-+-+x+-+-+-+-+
""",
    """
+-+-+o+-+-+
|         |
+         +
|         |
+  x      +
|         |
+-+-+-+-+-+
""",
]
